12 5 5 5 5 5 5 5 5 5 5 5 5 5 5 5 5 5 12
12 5 5 5 5 5 5 5 5 5 5 5 5 5 5 5 5 5 12
12 5 5 5 5 5 5 5 5 5 5 5 5 5 5 5 5 5 12
12 5 5 5 5 5 5 5 5 5 5 5 5 5 5 5 5 5 12
12 5 5 5 5 5 5 5 5 5 5 5 5 5 5 5 5 5 12
12 5 5 5 5 5 5 5 5 5 5 5 5 5 5 5 5 5 12
12 26 26 26 26 26 26 26 26 26 26 26 26 26 26 26 26 26 12
12 16 16 16 16 16 16 16 16 16 16 16 16 16 16 16 16 16 12
10 4 4 4 4 4 4 4 4 4 4 4 4 4 4 4 4 4 11
10 4 4 4 4 4 4 4 4 4 4 4 4 4 4 4 4 4 11
10 4 4 4 4 4 4 4 4 4 4 4 4 4 4 4 4 4 11
10 4 4 4 4 4 4 4 4 4 4 4 4 4 4 4 4 4 11
10 4 4 4 4 4 4 4 4 4 4 4 4 4 4 4 4 4 11
10 4 4 4 4 4 4 4 4 4 4 4 4 4 4 4 4 4 11
12 18 15 15 15 15 15 15 15 15 15 15 15 15 15 15 15 24 12
12 17 16 16 16 16 16 16 16 16 16 16 16 16 16 16 16 25 12
12 0 19 19 19 19 19 19 19 19 19 19 19 19 19 19 19 12 0
12 0 20 20 20 20 20 20 20 20 20 20 20 20 20 20 20 12 0
12 0 21 21 21 21 21 21 21 21 21 21 21 21 21 21 21 12 0
12 0 19 19 19 19 19 19 19 19 19 19 19 19 19 19 19 12 0
12 0 20 20 20 20 20 20 20 20 20 20 20 20 20 20 20 12 0
12 14 21 21 21 21 21 21 21 21 21 21 21 21 21 21 21 13 0
12 18 15 15 15 15 15 15 15 15 15 15 15 15 15 15 15 24 12
13 17 16 16 16 16 16 16 16 16 16 16 16 16 16 16 16 25 13
10 4 4 4 4 4 4 4 4 4 4 4 4 4 4 4 4 4 11
10 4 4 4 4 4 4 4 4 4 4 4 4 4 4 4 4 4 11
10 4 4 4 4 4 4 4 4 4 4 4 4 4 4 4 4 4 11
10 4 4 4 4 4 4 4 4 4 4 4 4 4 4 4 4 4 11
10 4 4 4 4 4 4 4 4 4 4 4 4 4 4 4 4 4 11
10 4 4 4 4 4 4 4 4 4 4 4 4 4 4 4 4 4 11
12 18 15 15 15 15 15 15 15 15 15 15 15 15 15 15 15 24 12
12 22 5 5 5 5 5 5 5 5 5 5 5 5 5 5 5 23 12
12 22 5 5 5 7 7 5 5 5 5 5 5 5 5 5 5 23 12
12 22 5 5 7 8 7 5 5 5 5 5 7 7 8 5 5 23 12
12 22 5 7 7 7 5 5 5 5 5 7 8 7 7 7 5 23 12
12 22 7 7 8 7 7 7 7 8 8 7 7 7 7 8 7 23 12
12 17 8 8 8 8 8 8 8 8 8 8 8 8 8 8 8 25 12
13 14 14 14 14 14 14 14 14 14 14 14 14 14 14 14 14 14 14